10,10
-1,07,01,01,01,01,01,01,08,-1
02,01,18,00,17,00,00,00,01,03
02,21,16,00,00,00,00,16,00,03
02,00,00,00,00,00,09,00,00,03
02,00,00,00,00,00,00,00,00,03
02,00,00,09,20,00,00,09,00,03
02,00,00,00,00,00,00,00,00,03
02,20,16,00,19,00,00,16,23,03
-1,05,20,00,00,18,00,20,06,-1
-1,-1,04,04,04,04,04,04,-1,-1