10,10
1,1,1,1,1,1,1,1,1,1
1,2,0,4,0,0,0,0,2,1
1,0,0,0,0,4,0,0,0,1
1,1,1,1,1,1,0,0,0,1
1,2,3,0,2,1,0,5,3,1
1,5,0,0,0,1,0,4,0,1
1,0,4,0,0,1,0,0,0,1
1,0,7,0,0,1,0,0,0,1
1,6,0,0,0,0,0,0,2,1
1,1,1,1,1,1,1,1,1,1