10,10
-1,07,01,01,01,01,01,01,08,-1
02,01,00,00,00,00,00,00,01,03
02,16,00,00,00,00,00,19,00,03
02,00,19,00,00,00,19,00,00,03
02,00,00,16,22,22,00,00,16,03
02,00,00,00,22,22,00,00,00,03
02,00,19,00,00,00,19,00,00,03
02,21,21,00,00,00,00,20,20,03
-1,05,16,00,00,00,00,20,06,-1
-1,-1,04,04,04,04,04,04,-1,-1