10,10
1,1,1,1,1,1,1,1,1,1
1,1,4,0,0,0,4,0,1,1
1,0,2,0,0,0,0,2,1,1
1,5,5,1,0,0,1,0,1,1
1,0,0,0,6,0,0,1,1,1
1,0,0,0,0,0,1,1,1,1
1,0,0,0,0,0,5,1,1,1
1,4,0,5,1,0,0,2,0,1
1,1,0,0,2,0,1,0,1,1
1,1,1,1,1,1,1,1,1,1