10,10
1,1,1,1,1,1,1,1,1,1
1,1,2,0,0,0,1,1,1,1
1,1,1,4,4,0,0,1,1,1
1,1,0,0,0,5,0,0,0,1
1,2,0,1,0,0,0,4,0,1
1,1,0,1,2,0,1,0,0,1
1,0,0,1,1,5,0,5,7,1
1,0,0,1,1,1,2,0,2,1
1,1,2,3,1,1,1,0,1,1
1,1,1,1,1,1,1,1,1,1